4104221404
2113441032
4102343221
0322411004
4302041320