0040000400
0044004400
0333003330
0333333330
0022222200
0022222200
0002222000
