0000440000
0004334000
0043223400
0032112300
0032112300
0043223400
0004334000
0000440000